1811111111111111111111111111111111111111
1000000000000000000000000010000011111101
1111111111111111111111111011111000000001
1000100010110001111000001000001011111011
1010001010111100000011101111101010001011
1000111010110101111110100000101010111011
1010001010000001000000010110101010000011
1010101011111111011111010010101110111111
1000101000000000010101011010101000001001
1010101110111101010101011010101111001001
1010000000000001010000010010100001011101
1011111111111011010101110000111101010101
1010000000001010010100000110000101010101
1010111101101010110101110000011101000101
1010100101100010100100111111111101101101
1010101100000000111110100000000100100101
1010101101111100100110101111110110101101
1010101001000100110000101000010000100101
1010101011011111100101101000011111101101
1000100010000000001100101111000000000001
1011101110111111101111100001111000111101
1000001000100010001001111101100011100001
1011111111101000100011000001100110001101
1011000000001111111111011111001100101101
1000011111111000000000010000111001100001
1011110000011011111111110110100000111111
1011010111011010000000000110101010000011
1000000111111010111110111111101010101011
1011010100111011100100100001101110100011
1000010110100000000001111100001000111111
1011110000101111111100000111101111100001
1001111110101010000101110000001000001111
1011000000001011110111011111111110100001
1010011111101000000000000000100010111111
1010110010101111111111110110001010010001
1010000110100000000000010000111011000101
1000110000111111111111010110000011111101
1011111100000000110000011110111110000001
1000000101111110000111000000000000111101
1111111111111111111111111111111111111131
