1811111111111111111111111111111111111111
1000000000000000000000000000000000000001
1111111111111111111111111111111111111101
1101101101101101101101101101101101101101
1101101101101101101101101101101101101101
1101101101101101101101101101101101101101
1101101101101101101101101101101101101101
1101101101101101101101101101101101101101
1101101101101101101101101101101101101101
1101101101101101101101101101101101101101
1101101101101101101101101101101101101101
1101101101101101101101101101101101101101
1101101101101101101101101101101101101101
1101101101101101101101101101101101101101
1101101101101101101101101101101101101101
1101101101101101101101101101101101101101
1101101101101101101101101101101101101101
1101101101101101101101101101101101101101
1101101101101101101101101101101101101101
1101101101101101101101101101101101101101
1101101101101101101101101101101101101101
1101101101101101101101101101101101101101
1101101101101101101101101101101101101101
1101101101101101101101101101101101101101
1101101101101101101101101101101101101101
1101101101101101101101101101101101101101
1101101101101101101101101101101101101101
1101101101101101101101101101101101101101
1101101101101101101101101101101101101101
1101101101101101101101101101101101101101
1101101101101101101101101101101101101101
1100000000000000000000000000000000000001
1111111111111111111011111111111111111111
1111111111111111111011111111111111111111
1111111111111111111011111111111111111111
1111111111111111111011111111111111111111
1111111111111111111011111111111111111111
1111111111111111111011111111111111111111
1111111111111111111000000000000000000001
1111111111111111111111111111111111111131
